#####0000000000#####
##                ##
^     99999        ^
*    5555555555    *
$                  $
2  8           7   3
2  8           7   3
2  8   4%%%4   7   3
2  8   44%%4   7   3
2  8   4xxx4   7   3
2  8   4tttx   7   3
2  8   xtttx   7   3
2  8   4tttx   7   3
2  8    xxx4   7   3
2  8           7   3
$                  $
*   6666666666     *
^      99999       ^
##                ##
#####1111111111#####