#############################
#######000   ^^   444########
#######000    ^    444#######
######000          444#######
######   0    t    4   ######
#####    $   tt   $    ######
#####     **  t  **     #####
####^    **      **    ^#####
####^^        x        ^^####
###   tt     xx     tt   ####
###    tt     x     tt    ###
##       xx      xx       ###
##2       xx ~%~ xx       3##
#22   *     %  %     *   33##
#2222$**    ~ + ~    **$3333#
#22   *     %  %     *   33##
##2       xx ~%~ xx       3##
##       xx      xx       ###
###    tt     x     tt    ###
###   tt     xx     tt   ####
####^^        x        ^^####
####^    **      **    ^#####
#####     **  t  **     #####
#####    $   tt   $    ######
######   5    t    1   ######
######555          111#######
#######555    ^    111#######
#######555   ^^   111########
#############################