^^0000000000#             #     # #3333333333    
###### ############ #####t# ## # # ####### #### #
  #          #    t#     # # # #   #           # 
# #### ### # # ### 99### # # ___# # ########## # 
#         # # #999###9### # # # # #   $$$$    # #
######### # # ###999#9### #  # # # # ####### # # 
#        # # # # # # # ### # # # # #         # # 
#######  # # ##    # #     # # # # # #### ### # #
        #___#   ### #  #### # # # #           # #
 #### ### # # ##  # # # x   # # # # #### #####   
 #5555555# #     # ### # ### # # #  #         4# 
 #555 #### ##### ##6666#6# # # # ###  #########4#
 ##########   +   #666#66#    # #  # ##44444444t#
        # ####### #*# #x# ##### ##  #  ##########
####### #        # #*# #x #x       ## #    __   #
       # ##### ### #*# # # ### ##    #.#### ### #
# ####t# #   #    # #*#   # #   # ## # #   __  # 
 #  # # # # # ###   # ### # # # # # # # ###### # 
 # ## # # # # #    #77777#77 # #+# ## # #     # #
  ## # # # # #_### # # #777# # # #t# # # #### # #
####.  # # #  _#  # # # # # #   #    # # #   # # 
  # #   # # #_  ##  # # # # # # # # # # # ## # # 
 ## # # # # # ## #  #  # # # # # # ## # # # # #  
   # # # # # #    # #### # # # #   # #.# # # # # 
 # # #   # # # ##### ### # # # # ## # # # #  # # 
# # # ###t# #  #   #  # # #  # # # ## # # ###1# #
#2# #     #  # #### # ## # ## # # # ## # #1111# #
2#2#2### # #      # #888#888# # #   ## # #####^##
^#2#2#2# # ####### #888#8# # #   # # ## #11111^##
#^#222# #        # # ## # ## # # # #   ##########