00#     #     #   #
00#     #     # #1#
00#  #  ~  #  # #1#
  #  #  ~  #%%# #1#
     #  #  #%%# #1#
     #  #  #&%# #1#
############    #1#