##########################
#00000              22222#
#00000              22222#
#                        #
#                        #
#                        #
#                        #
#                        #
#.        ~4444%         #
#         %4444~        .#
#                        #
#                        #
#                        #
#                        #
#                        #
#33333              11111#
#33333              11111#
##########################