#####0000000000#####
##                ##
^                  ^
*                  *
$                  $
2                  3
2                  3
2       %%%        3
2        +%        3
2       xxx        3
2       tttx       3
2      xtttx       3
2       tttx       3
2       xxx        3
2                  3
$                  $
*                  *
^                  ^
##                ##
#####1111111111#####